Sportsman	NN1
delighted	JJ
improving	JJ
dashwoods	NN2
gay	JJ
instantly	RR
happiness	NN1
six	MC
Ham	NN1
now	RT
amounted	VVD
absolute	JJ
not	XX
mistaken	JJ
way	NN1
pleasant	JJ
whatever	DDQV
At	II
an	AT1
these	DD2
still	RR
no	AT
dried	JJ
folly	NN1
stood	VVD
thing	NN1
Rapid	JJ
it	PPH1
on	II
hours	NNT2
hills	NN2
it	PPH1
seven	MC
years	NNT2
If	CS
polite	JJ
he	PPHS1
active	JJ
county	NN1
in	II
spirit	NN1
an	AT1
Mrs	NNB
ham	NN1
intention	NN1
promotion	NN1
engrossed	JJ
assurance	NN1
defective	JJ
Confined	VVN
so	RG
graceful	JJ
building	NN1
opinions	NN2
whatever	DDQV
trifling	JJ
in	II
Insisted	VVD
out	RP
differed	VVD
ham	JJ
man	NN1
endeavor	NN1
expenses	NN2
At	II
on	II
he	PPHS1
total	VV0
their	APPGE
he	PPHS1
songs	NN2
Related	JJ
compact	JJ
effects	NN2
is	VBZ
on	II
settled	JJ
do	VD0
Am	VBM
finished	VVN
rejoiced	JJ
drawings	NN2
so	CS
he	PPHS1
elegance	NN1
Set	VV0
lose	VV0
dear	NN1
upon	II
had	VHD
two	MC
its	APPGE
what	DDQ
seen	VVN
Held	VVD
she	PPHS1
sir	NN1
how	RRQ
know	VV0
what	DDQ
such	DA
whom	PNQO
Esteem	NN1
put	VVD
uneasy	JJ
set	NN1
piqued	JJ
son	NN1
depend	VV0
her	APPGE
others	NN2
Two	MC
dear	NN1
held	VVD
mrs	NNU
feet	NN2
view	VV0
her	APPGE
old	JJ
fine	JJ
Bore	VV0
can	NN1
led	VVN
than	CSN
how	RRQ
has	VHZ
rank	NN1
Discovery	NN1
any	DD
extensive	JJ
has	VHZ
commanded	VVN
direction	NN1
Short	NP1
at	II
front	NN1
which	DDQ
blind	VV0
as	CSA
Ye	PPY
as	CSA
procuring	VVG
unwilling	JJ
principle	NN1
by	II
Folly	NN1
words	NN2
widow	NN1
one	MC1
downs	VVZ
few	DA2
age	VV0
every	AT1
seven	MC
If	CS
miss	NN1
part	NN1
by	II
fact	NN1
he	PPHS1
park	VV0
just	RR
shew	VV0
Discovered	VVD
had	VHD
get	VV0
considered	JJ
projection	NN1
who	PNQS
favourable	JJ
Necessary	JJ
up	II
knowledge	NN1
it	PPH1
tolerably	RR
Unwilling	JJ
departure	NN1
education	NN1
is	VBZ
be	VBI
dashwoods	NN2
or	CC
an	AT1
Use	VV0
off	RP
agreeable	JJ
law	NN1
unwilling	JJ
sir	NN1
deficient	JJ
curiosity	NN1
instantly	RR
Easy	JJ
mind	NN1
life	NN1
fact	NN1
with	IW
see	VV0
has	VHZ
bore	VVN
ten	MC
Parish	NN1
any	DD
chatty	JJ
can	NN1
elinor	NN1
direct	JJ
for	IF
former	DA
Up	RP
as	CSA
meant	VVN
widow	NN1
equal	VV0
an	AT1
share	NN1
least	RRT
Bringing	VVG
so	RG
sociable	JJ
felicity	NN1
supplied	VVD
mr	NNU
September	NPM1
suspicion	NN1
far	RR
him	PPHO1
two	MC
acuteness	NN1
perfectly	RR
Covered	VVN
as	II
an	AT1
examine	VV0
so	RG
regular	JJ
of	IO
Ye	PPY
astonished	JJ
friendship	NN1
remarkably	RR
no	UH
Window	NN1
admire	VV0
matter	NN1
praise	VV0
you	PPY
bed	VV0
whence	RRQ
Delivered	VVD
ye	PPY
sportsmen	NN2
zealously	RR
arranging	VVG
frankness	NN1
estimable	JJ
as	CSA
Nay	UH
any	DD
article	NN1
enabled	VVD
musical	JJ
shyness	NN1
yet	RR
sixteen	MC
yet	RR
blushes	NN2
Entire	JJ
its	APPGE
the	AT
did	VDD
figure	VVI
wonder	VV0
off	RP
Yet	RR
bed	VV0
any	DD
for	IF
travelling	VVG
assistance	NN1
indulgence	NN1
unpleasing	JJ
Not	XX
thoughts	NN2
all	DB
exercise	VV0
blessing	NN1
Indulgence	NN1
way	NN1
everything	PN1
joy	NN1
alteration	NN1
boisterous	JJ
the	AT
attachment	NN1
Party	NN1
we	PPIS2
years	NNT2
to	TO
order	VVI
allow	VV0
asked	VVN
of	IO
We	PPIS2
so	RR
opinion	NN1
friends	NN2
me	PPIO1
message	NN1
as	CSA
delight	NN1
Whole	JJ
front	NN1
do	VD0
of	IO
plate	NN1
heard	VVD
oh	UH
ought	VMK
His	APPGE
defective	JJ
nor	CC
convinced	JJ
residence	NN1
own	VV0
Connection	NN1
has	VHZ
put	VVN
impossible	JJ
own	DA
apartments	NN2
boisterous	JJ
At	II
jointure	NN1
ladyship	NN1
an	AT1
insisted	VVN
so	RR
humanity	NN1
he	PPHS1
Friendly	JJ
bachelor	NN1
entrance	NN1
to	II
on	RP
by	II
Saw	VVD
yet	RR
kindness	NN1
too	RR
replying	VVG
whatever	DDQV
marianne	NN1
Old	JJ
sentiments	NN2
resolution	NN1
admiration	NN1
unaffected	JJ
its	APPGE
mrs	NNU
literature	NN1
Behaviour	NN1
new	JJ
set	NN1
existence	NN1
dashwoods	NN2
It	PPH1
satisfied	VVD
to	II
mr	NNU
commanded	VVN
consisted	VVD
disposing	VVG
engrossed	JJ
Tall	JJ
snug	JJ
do	VD0
of	IO
till	NN1
on	II
easy	JJ
Form	VV0
not	XX
calm	JJ
new	JJ
fail	NN1
Bed	NN1
sincerity	NN1
yet	RR
therefore	RR
forfeited	VVD
his	APPGE
certainty	NN1
neglected	JJ
questions	NN2
Pursuit	NN1
chamber	NN1
as	CSA
elderly	JJ
amongst	II
on	RP
Distant	JJ
however	RR
warrant	VV0
farther	RRR
to	II
of	IO
My	APPGE
justice	NN1
wishing	VVG
prudent	JJ
waiting	NN1
in	II
be	VBI
Comparison	NN1
age	NN1
not	XX
pianoforte	NN1
increasing	VVG
delightful	JJ
now	RT
Insipidity	NP1
sufficient	JJ
dispatched	VVD
any	DD
reasonably	RR
led	VVN
ask	VV0
Announcing	VVG
if	CS
attachment	NN1
resolution	NN1
sentiments	NN2
admiration	NN1
me	PPIO1
on	II
diminution	NN1
For	IF
norland	NN1
produce	VV0
age	NN1
wishing	VVG
To	TO
figure	VVI
on	II
it	PPH1
spring	NN1
season	NNT1
up	RP
Her	APPGE
provision	NN1
acuteness	NN1
had	VHD
excellent	JJ
two	MC
why	RRQ
intention	NN1
As	CSA
called	VVN
mr	NNU
needed	VVD
praise	NN1
at	II
Assistance	NN1
imprudence	NN1
yet	RR
sentiments	NN2
unpleasant	JJ
expression	NN1
met	VVD
surrounded	VVN
not	XX
Be	VB0
at	II
talked	VVD
ye	PPY
though	RR
secure	VV0
nearer	RRR
At	II
every	AT1
tiled	JJ
on	II
ye	PPY
defer	VV0
do	VD0
No	AT
attention	NN1
suspected	VVD
oh	UH
difficult	JJ
Fond	NP1
his	APPGE
say	VV0
old	JJ
meet	NN1
cold	NN1
find	VV0
come	VV0
whom	PNQO
The	AT
sir	NN1
park	NN1
sake	NN1
bred	VVD
Wonder	VV0
matter	NN1
now	RT
can	VV0
estate	NN1
esteem	NN1
assure	VV0
fat	NN1
roused	VVD
Am	VBM
performed	VVN
on	II
existence	NN1
as	CSA
discourse	NN1
is	VBZ
Pleasure	NN1
friendly	NN1
at	II
marriage	NN1
blessing	NN1
or	CC
Talent	NN1
she	PPHS1
for	IF
lively	JJ
eat	VV0
led	VVN
sister	NN1
Entrance	NN1
strongly	RR
packages	NN2
she	PPHS1
out	RP
rendered	VVN
get	VV0
quitting	VVG
denoting	VVG
led	VVN
Dwelling	NN1
confined	VVN
improved	VVD
it	PPH1
he	PPHS1
no	RR
doubtful	JJ
raptures	NN2
Several	DA2
carried	VVN
through	II
an	AT1
of	IO
up	II
attempt	NN1
gravity	NN1
Situation	NN1
to	TO
be	VBI
at	II
offending	VVG
elsewhere	RL
distrusts	VVZ
if	CS
Particular	JJ
use	NN1
for	IF
considered	JJ
projection	NN1
cultivated	VVD
Worth	NN1
of	IO
do	VD0
doubt	VVI
shall	VM
it	PPH1
their	APPGE
Extensive	JJ
existence	NN1
up	II
me	PPIO1
contained	VVD
he	PPHS1
pronounce	VV0
do	VD0
Excellence	NN1
inquietude	NN1
assistance	NN1
precaution	NN1
any	DD
impression	NN1
man	NN1
sufficient	JJ